MODE 0
SIZE 11/30
LIMIT 0/60
COLOR LIMIT 4
STARS 800/1600/2700
6 6 6 6 6 6 6 6 6 6 6
0 0 6 0 0 0 6 0 0 0 0
6 6 6 6 6 0 0 6 6 6 6
0 0 6 6 0 0 0 0 6 6 0
0 0 0 6 0 0 0 0 6 0 0
0 6 0 0 6 0 0 6 0 6 0
6 6 6 0 6 6 6 6 6 6 6
6 0 6 6 0 6 6 0 0 0 6
0 0 0 0 0 0 0 0 0 0 0
0 0 0 0 0 0 0 0 0 0 0
0 0 0 0 0 0 0 0 0 0 0
0 0 0 0 0 0 0 0 0 0 0
0 0 0 0 0 0 0 0 0 0 0
0 0 0 0 0 0 0 0 0 0 0
0 0 0 0 0 0 0 0 0 0 0
0 0 0 0 0 0 0 0 0 0 0
0 0 0 0 0 0 0 0 0 0 0
0 0 0 0 0 0 0 0 0 0 0
0 0 0 0 0 0 0 0 0 0 0
0 0 0 0 0 0 0 0 0 0 0
0 0 0 0 0 0 0 0 0 0 0
0 0 0 0 0 0 0 0 0 0 0
0 0 0 0 0 0 0 0 0 0 0
0 0 0 0 0 0 0 0 0 0 0
0 0 0 0 0 0 0 0 0 0 0
0 0 0 0 0 0 0 0 0 0 0
0 0 0 0 0 0 0 0 0 0 0
0 0 0 0 0 0 0 0 0 0 0
0 0 0 0 0 0 0 0 0 0 0
0 0 0 0 0 0 0 0 0 0 0
