MODE 0
SIZE 11/30
LIMIT 0/60
COLOR LIMIT 5
STARS 1200/2400/4100
6 6 6 6 6 6 6 6 6 6 6
6 6 0 6 6 0 0 6 6 0 0
0 0 0 6 0 0 0 6 0 0 0
0 0 0 0 6 6 0 6 6 0 0
0 0 6 6 0 6 6 6 0 6 6
0 0 6 6 0 6 6 0 0 6 6
0 0 0 6 0 0 6 0 0 0 6
6 6 6 0 6 6 6 6 6 6 6
0 0 6 0 0 0 6 0 0 6 0
0 6 6 0 0 6 6 0 0 6 6
0 6 6 6 0 6 6 0 6 6 6
0 0 6 6 0 0 6 6 0 0 6
0 0 6 0 0 0 0 0 0 0 0
0 0 0 0 0 0 0 0 0 0 0
0 0 0 0 0 0 0 0 0 0 0
0 0 0 0 0 0 0 0 0 0 0
0 0 0 0 0 0 0 0 0 0 0
0 0 0 0 0 0 0 0 0 0 0
0 0 0 0 0 0 0 0 0 0 0
0 0 0 0 0 0 0 0 0 0 0
0 0 0 0 0 0 0 0 0 0 0
0 0 0 0 0 0 0 0 0 0 0
0 0 0 0 0 0 0 0 0 0 0
0 0 0 0 0 0 0 0 0 0 0
0 0 0 0 0 0 0 0 0 0 0
0 0 0 0 0 0 0 0 0 0 0
0 0 0 0 0 0 0 0 0 0 0
0 0 0 0 0 0 0 0 0 0 0
0 0 0 0 0 0 0 0 0 0 0
0 0 0 0 0 0 0 0 0 0 0
