MODE 0
SIZE 11/30
LIMIT 0/30
COLOR LIMIT 5
STARS 1900/3600/6300
0 0 0 0 0 6 6 6 6 6 0
0 0 0 0 6 6 6 6 6 6 6
0 0 0 0 0 0 6 6 0 0 6
0 0 0 6 6 6 6 6 6 6 0
0 0 6 6 6 0 0 6 6 6 6
6 6 6 0 0 6 6 6 6 6 6
6 6 6 6 0 0 0 0 6 6 6
0 6 6 0 0 0 0 0 0 0 0
0 0 6 6 6 0 0 0 0 0 0
0 0 0 0 0 0 0 0 0 0 0
0 0 0 0 0 0 0 0 0 0 0
0 0 0 0 0 0 0 0 0 0 0
0 0 0 0 0 0 0 0 0 0 0
0 0 0 0 0 0 0 0 0 0 0
0 0 0 0 0 0 0 0 0 0 0
0 0 0 0 0 0 0 0 0 0 0
0 0 0 0 0 0 0 0 0 0 0
0 0 0 0 0 0 0 0 0 0 0
0 0 0 0 0 0 0 0 0 0 0
0 0 0 0 0 0 0 0 0 0 0
0 0 0 0 0 0 0 0 0 0 0
0 0 0 0 0 0 0 0 0 0 0
0 0 0 0 0 0 0 0 0 0 0
0 0 0 0 0 0 0 0 0 0 0
0 0 0 0 0 0 0 0 0 0 0
0 0 0 0 0 0 0 0 0 0 0
0 0 0 0 0 0 0 0 0 0 0
0 0 0 0 0 0 0 0 0 0 0
0 0 0 0 0 0 0 0 0 0 0
0 0 0 0 0 0 0 0 0 0 0
