MODE 0
SIZE 11/30
LIMIT 0/29
COLOR LIMIT 5
STARS 5500/8300/15000
6 6 6 6 6 6 6 6 6 6 6
0 6 6 0 0 6 6 0 6 6 0
0 0 6 0 0 0 6 0 0 0 6
0 6 6 0 0 6 6 0 0 6 6
0 6 6 0 6 6 6 0 6 6 6
0 6 6 0 0 6 6 0 6 6 0
0 0 6 0 0 6 0 0 0 6 0
6 6 6 6 6 6 6 0 6 6 6
0 0 0 6 0 0 6 0 0 0 6
0 0 0 0 0 0 0 0 0 0 0
0 0 0 0 0 0 0 0 0 0 0
0 0 0 0 0 0 0 0 0 0 0
0 0 0 0 0 0 0 0 0 0 0
0 0 0 0 0 0 0 0 0 0 0
0 0 0 0 0 0 0 0 0 0 0
0 0 0 0 0 0 0 0 0 0 0
0 0 0 0 0 0 0 0 0 0 0
0 0 0 0 0 0 0 0 0 0 0
0 0 0 0 0 0 0 0 0 0 0
0 0 0 0 0 0 0 0 0 0 0
0 0 0 0 0 0 0 0 0 0 0
0 0 0 0 0 0 0 0 0 0 0
0 0 0 0 0 0 0 0 0 0 0
0 0 0 0 0 0 0 0 0 0 0
0 0 0 0 0 0 0 0 0 0 0
0 0 0 0 0 0 0 0 0 0 0
0 0 0 0 0 0 0 0 0 0 0
0 0 0 0 0 0 0 0 0 0 0
0 0 0 0 0 0 0 0 0 0 0
0 0 0 0 0 0 0 0 0 0 0
0 0 0 0 0 0 0 0 0 0 0