MODE 0
SIZE 11/30
LIMIT 0/40
COLOR LIMIT 5
STARS 4500/8000/10000
6 6 6 6 6 6 6 6 6 6 6
6 6 6 0 6 6 6 6 6 6 6
0 0 0 0 0 0 0 0 0 6 6
0 0 0 0 0 0 0 0 0 6 6
0 0 0 6 6 6 6 6 6 6 6
0 0 6 6 6 6 6 6 6 6 0
0 0 0 0 0 0 6 6 0 0 0
0 0 0 0 0 0 0 0 0 6 6
6 6 6 6 6 6 6 6 0 0 6
6 6 6 0 0 0 6 6 6 6 6
0 0 6 6 0 0 0 0 0 0 0
0 0 6 6 0 0 0 0 0 0 0
6 6 6 6 6 6 6 0 0 6 6
6 6 6 0 0 0 6 6 6 6 6
0 0 0 0 0 0 0 6 0 0 0
0 0 0 0 6 0 0 0 0 0 0
6 0 0 6 6 6 6 6 6 6 6
6 6 6 6 6 6 0 0 0 6 6
0 6 0 0 0 0 0 0 0 0 0
0 0 0 6 0 0 0 0 0 0 0
6 6 6 6 6 6 6 0 0 6 6
6 6 0 0 0 6 6 6 6 6 6
0 0 0 0 6 6 0 0 0 0 0
0 0 0 0 0 0 0 6 6 0 0
0 0 0 0 0 0 0 6 6 6 6
0 0 0 0 0 6 6 6 6 6 6
0 0 0 0 0 0 0 0 0 0 0
0 0 0 0 0 0 0 0 0 0 0
0 0 0 0 0 0 0 0 0 0 0
0 0 0 0 0 0 0 0 0 0 0
0 0 0 0 0 0 0 0 0 0 0