MODE 0
SIZE 11/30
LIMIT 0/30
COLOR LIMIT 5
STARS 2000/4000/6000
6 6 6 6 6 6 6 6 6 6 6
6 6 6 6 6 6 6 6 6 6 6
0 0 0 6 6 0 0 0 0 0 0
0 0 0 0 0 0 0 0 6 6 0
6 6 6 6 0 0 0 6 6 0 0
6 6 6 6 6 6 6 6 6 6 6
6 6 6 6 0 0 6 6 0 0 6
6 6 0 0 0 0 0 6 0 0 0
0 0 0 0 0 0 0 6 6 0 0
0 0 6 6 6 6 6 6 6 0 0
0 6 6 0 0 6 6 6 6 0 0
0 6 6 6 6 6 6 6 6 6 0
0 0 6 6 6 6 6 0 0 0 0
0 0 0 0 6 0 6 0 0 0 0
0 0 0 0 0 0 0 0 0 0 0
0 0 0 0 0 0 0 0 0 0 0
0 0 0 0 0 0 0 0 0 0 0
0 0 0 0 0 0 0 0 0 0 0
0 0 0 0 0 0 0 0 0 0 0
0 0 0 0 0 0 0 0 0 0 0
0 0 0 0 0 0 0 0 0 0 0
0 0 0 0 0 0 0 0 0 0 0
0 0 0 0 0 0 0 0 0 0 0
0 0 0 0 0 0 0 0 0 0 0
0 0 0 0 0 0 0 0 0 0 0
0 0 0 0 0 0 0 0 0 0 0
0 0 0 0 0 0 0 0 0 0 0
0 0 0 0 0 0 0 0 0 0 0
0 0 0 0 0 0 0 0 0 0 0
0 0 0 0 0 0 0 0 0 0 0
0 0 0 0 0 0 0 0 0 0 0