MODE 0
SIZE 11/30
LIMIT 0/30
COLOR LIMIT 5
STARS 2500/4500/6500
6 6 6 6 6 6 6 6 6 6 6
6 6 6 6 6 6 6 6 6 6 0
6 6 6 6 6 6 6 6 6 6 6
6 6 6 6 0 0 6 0 0 6 6
6 6 6 0 0 6 6 6 6 0 0
6 6 0 0 0 6 6 6 0 0 0
6 6 0 0 0 0 0 0 6 6 6
0 0 0 0 0 6 6 6 6 6 0
6 6 6 6 6 6 6 0 0 0 0
6 6 6 6 6 0 0 0 0 6 6
0 0 6 6 6 6 6 6 6 6 6
6 6 6 6 0 0 6 6 6 6 6
6 6 6 6 6 6 6 6 6 6 6
0 0 0 0 0 0 0 0 0 0 0
0 0 0 0 0 0 0 0 0 0 0
0 0 0 0 0 0 0 0 0 0 0
0 0 0 0 0 0 0 0 0 0 0
0 0 0 0 0 0 0 0 0 0 0
0 0 0 0 0 0 0 0 0 0 0
0 0 0 0 0 0 0 0 0 0 0
0 0 0 0 0 0 0 0 0 0 0
0 0 0 0 0 0 0 0 0 0 0
0 0 0 0 0 0 0 0 0 0 0
0 0 0 0 0 0 0 0 0 0 0
0 0 0 0 0 0 0 0 0 0 0
0 0 0 0 0 0 0 0 0 0 0
0 0 0 0 0 0 0 0 0 0 0
0 0 0 0 0 0 0 0 0 0 0
0 0 0 0 0 0 0 0 0 0 0
0 0 0 0 0 0 0 0 0 0 0
0 0 0 0 0 0 0 0 0 0 0