MODE 0
SIZE 11/30
LIMIT 0/29
COLOR LIMIT 5
STARS 3500/5200/7300
6 6 6 6 6 6 6 6 6 6 6
6 6 0 6 6 0 6 6 0 6 6
6 0 6 6 0 0 6 6 0 6 6
0 0 0 6 6 0 6 6 0 6 6
6 6 0 0 0 0 6 6 0 6 0
6 6 6 6 6 0 0 0 0 0 0
6 6 6 6 6 6 0 0 0 0 0
6 6 0 0 6 6 6 0 0 0 0
0 0 0 0 0 6 6 0 0 0 0
0 0 0 0 6 6 6 6 6 0 0
6 6 6 6 6 6 6 6 6 6 6
6 0 6 6 6 6 6 6 6 6 6
0 0 0 0 6 6 0 0 6 6 0
0 0 0 6 6 0 0 0 0 6 6
0 0 0 6 6 0 0 0 6 6 0
0 0 0 0 0 0 0 0 0 0 0
0 0 0 0 0 0 0 0 0 0 0
0 0 0 0 0 0 0 0 0 0 0
0 0 0 0 0 0 0 0 0 0 0
0 0 0 0 0 0 0 0 0 0 0
0 0 0 0 0 0 0 0 0 0 0
0 0 0 0 0 0 0 0 0 0 0
0 0 0 0 0 0 0 0 0 0 0
0 0 0 0 0 0 0 0 0 0 0
0 0 0 0 0 0 0 0 0 0 0
0 0 0 0 0 0 0 0 0 0 0
0 0 0 0 0 0 0 0 0 0 0
0 0 0 0 0 0 0 0 0 0 0
0 0 0 0 0 0 0 0 0 0 0
0 0 0 0 0 0 0 0 0 0 0
0 0 0 0 0 0 0 0 0 0 0