MODE 0
SIZE 11/30
LIMIT 0/30
COLOR LIMIT 5
STARS 2600/3800/4900
0 0 0 0 0 0 0 0 0 0 0
0 0 0 0 0 0 0 0 0 0 0
0 0 0 0 0 6 6 0 0 6 6
0 0 0 0 0 6 6 6 6 6 0
6 6 0 0 0 0 0 6 6 6 6
6 6 0 0 0 0 6 6 6 6 6
6 6 6 6 0 0 6 6 6 6 6
6 6 6 6 6 6 6 6 6 6 6
0 6 6 0 0 6 6 6 6 6 0
0 6 6 0 0 6 6 0 0 0 0
0 6 6 0 0 6 6 6 6 6 0
6 6 6 0 0 6 6 6 6 6 6
6 6 0 0 0 6 6 6 6 6 6
6 6 6 6 6 6 0 0 0 6 6
6 6 6 6 6 0 0 0 0 0 0
6 0 0 0 0 0 0 0 0 0 0
0 0 0 0 0 0 0 0 0 0 0
0 0 0 0 0 0 0 0 0 0 0
0 0 0 0 0 0 0 0 0 0 0
0 0 0 0 0 0 0 0 0 0 0
0 0 0 0 0 0 0 0 0 0 0
0 0 0 0 0 0 0 0 0 0 0
0 0 0 0 0 0 0 0 0 0 0
0 0 0 0 0 0 0 0 0 0 0
0 0 0 0 0 0 0 0 0 0 0
0 0 0 0 0 0 0 0 0 0 0
0 0 0 0 0 0 0 0 0 0 0
0 0 0 0 0 0 0 0 0 0 0
0 0 0 0 0 0 0 0 0 0 0
0 0 0 0 0 0 0 0 0 0 0
0 0 0 0 0 0 0 0 0 0 0